111111111111111111111111111
111111111100000000000000001
10000000E100000000000000001
100001111100000000011111111
100000000000000000000000001
10000000000000000000000C001
100000000000000000000011111
100000000000000000000010001
11110000000000000000C010001
111100000000000000111110001
100000000000000000000000001
100000000000000111111111111
100000000000000000000000001
10000000P00000010C000000001
111111111111111111111111111