111111111111111111111111111
10000000E1000000000000000M1
100001111100000000011111111
10000000000000000000000C001
100000000000000000000011111
11110000000000000000C010001
100000000000000001000000001
100000000000000110011111111
10000000P00000010C000000001
111111111111111111111111111