111111111111111111111111
10000000E100000000000001
100001111100000011111111
100000000000000000C0C001
11110000000000000CM10001
100000000000001000C00001
100000000000110011111111
10000000P00010C000000001
111111111111111111111111